 Manor
An Interactive Fiction by Phillip Tanton "A woman has been killed at her house, Milton Manor, in the countryside of Cornwall. The local police chief and Scotland yard have had little luck finding the perpatrator. It is your job as the renowned Sherlock Holmes to discover the clues hidden inside the house."
Release 1 / Serial number 141001 / Inform 7 build 6L38 (I6/v6.33 lib 6/12N) SD

Front porch
A simple porch, with two lamps, a reclining chair and a withered old deck.

>x porch
You can't see any such thing.

* * *

>x lamps
You can't see any such thing.

>x chair
You can't see any such thing.

* * *

 Manor
An Interactive Fiction by Phillip Tanton "A woman has been killed at her house, Milton Manor, in the countryside of Cornwall. The local police chief and Scotland yard have had little luck finding the perpatrator. It is your job as the renowned Sherlock Holmes to discover the clues hidden inside the house."
Release 1 / Serial number 141001 / Inform 7 build 6L38 (I6/v6.33 lib 6/12N) SD

Front porch
A simple porch, with two lamps, a reclining chair and a withered old deck.

>s
Main Hall
The entrance where visitors are brought. It has an expansive cealing and large woven rugs on a tiled floor. It is here that a representitive of Scotland yard has taken up office. 

You can see a servants door, Suit of armor and Scotland Yard here.

>w
West wing
Tradtionally the guest bedroom, the west wing is a simply decorated space. The is a great red curtain on the wall you are now facing. To your right is a closet and dressar. They are made of quality oak and seem to impose temselves into the room, as opposed to fitting in with it. The left part of the room contains the guest bed, the bedside table and the reading lamp on top.

>e
Main Hall
You can see servents door here.

>e
(first opening servents door)
It seems to be locked.

* * *

>w
West wing
Tradtionally the guest bedroom, the west wing is a simply decorated space. The is a great red curtain on the wall you are now facing. To your right is a closet and dressar. They are made of quality oak and seem to impose temselves into the room, as opposed to fitting in with it. The left part of the room contains the guest bed, the bedside table and the reading lamp on top.

>x dresser
a classic dresser with three drawers and some figurines on top. The wood working is of the highest quality and the caprpenter coate the dresser in varnish so that it could shine.

In Dresser are Top drawer, Middle drawer and Bottom drawer.

>x dressar
You can't see any such thing.

>x top drawer
It is empty. No one has slept in the guest bedroom for a while.

>x middle drawer
this one is also empty.

>x bottom drawer
This one seems empty too, but ...

In Bottom drawer is Pants.

>get pants
Taken.

>get all
Jacket: Taken.
Sweater: Taken.
Phone number: Taken.
Top drawer: Taken.
Middle drawer: Taken.
Bottom drawer: Taken.

>i
You are carrying:
  Bottom drawer
  Middle drawer
  Top drawer
  Phone number
  Sweater
  Jacket
  Pants

* * *

>w
West wing
Tradtionally the guest bedroom, the west wing is a simply decorated space. The is a great red curtain on the wall you are now facing. To your right is a closet and dressar. They are made of quality oak and seem to impose temselves into the room, as opposed to fitting in with it. The left part of the room contains the guest bed, the bedside table and the reading lamp on top.

>w
You can't go that way.

>w
You can't go that way.

I beg your pardon?

* * *

>s
Main Hall
The entrance where visitors are brought. It has an expansive cealing and large woven rugs on a tiled floor. It is here that a representitive of Scotland yard has taken up office. 

You can see a servants door, Suit of armor and Scotland Yard here.

>s
Grand staircase
The main feature in this room is of course the grand staircase. It has carvings showing the story of the milton family and the beggining of this house. There are images of the ancestors of hte current Milton Family. neat rows of Fuedal lords and Renasiance magistrates. They all have the same stern narrow jawbone.

>s
Master Bedroom
The keep of this castle. It a heavily furnished room, one large rug on the bottom and two curtains hanging. Both contain war scenes. One is about a man holding off the enemy at a bridge, while his comrades escape and destroy the bridge behind him.

>s
You can't go that way.

>s
You can't go that way.

I beg your pardon?

>s
You can't go that way.

* * *

I beg your pardon?

>ww
That's not a verb I recognise.

>w
You can't go that way.

>n
Grand staircase
The main feature in this room is of course the grand staircase. It has carvings showing the story of the milton family and the beggining of this house. There are images of the ancestors of hte current Milton Family. neat rows of Fuedal lords and Renasiance magistrates. They all have the same stern narrow jawbone.

>n
Main Hall
The entrance where visitors are brought. It has an expansive cealing and large woven rugs on a tiled floor. It is here that a representitive of Scotland yard has taken up office. 

You can see a servants door, Suit of armor and Scotland Yard here.

>n
Front porch
A simple porch, with two lamps, a reclining chair and a withered old deck.

>s
Main Hall
The entrance where visitors are brought. It has an expansive cealing and large woven rugs on a tiled floor. It is here that a representitive of Scotland yard has taken up office. 

You can see a servants door, Suit of armor and Scotland Yard here.

* * *

>s
Master Bedroom
The keep of this castle. It a heavily furnished room, one large rug on the bottom and two curtains hanging. Both contain war scenes. One is about a man holding off the enemy at a bridge, while his comrades escape and destroy the bridge behind him.

>n
Grand staircase
The main feature in this room is of course the grand staircase. It has carvings showing the story of the milton family and the beggining of this house. There are images of the ancestors of hte current Milton Family. neat rows of Fuedal lords and Renasiance magistrates. They all have the same stern narrow jawbone.

>l painting
A simple painting of "Son of Man", obviolsy a replica but interesting all the same. The edges of the wall seem to be worn. perhaps it is moved around quite often.

* * *

>s
You can't go that way.

>ss
That's not a verb I recognise.

I beg your pardon?

I beg your pardon?

>w
You can't go that way.

* * *

I beg your pardon?

>n
Grand staircase
The main feature in this room is of course the grand staircase. It has carvings showing the story of the milton family and the beggining of this house. There are images of the ancestors of hte current Milton Family. neat rows of Fuedal lords and Renasiance magistrates. They all have the same stern narrow jawbone.

* * *

>n
Front porch
A simple porch, with two lamps, a reclining chair and a withered old deck.

>n
You can't go that way.

>n
You can't go that way.

>nn
That's not a verb I recognise.

>n
You can't go that way.

I beg your pardon?

>n
You can't go that way.

* * *

>s
Grand staircase
The main feature in this room is of course the grand staircase. It has carvings showing the story of the milton family and the beggining of this house. There are images of the ancestors of hte current Milton Family. neat rows of Fuedal lords and Renasiance magistrates. They all have the same stern narrow jawbone.

>l painting
A simple painting of "Son of Man", obviolsy a replica but interesting all the same.

>l
Grand staircase

>painting
That's not a verb I recognise.

>x painting
A simple painting of "Son of Man", obviolsy a replica but interesting all the same.

>l painting
A simple painting of "Son of Man", obviolsy a replica but interesting all the same.

>get safe
That's hardly portable.

>open painting
It isn't something you can open.

>x sfe
You can't see any such thing.

>x safe
A heavy safe with a numbered code.

* * *

>s
Grand staircase
The main feature in this room is of course the grand staircase. It has carvings showing the story of the milton family and the beggining of this house. There are images of the ancestors of hte current Milton Family. neat rows of Fuedal lords and Renasiance magistrates. They all have the same stern narrow jawbone.

>w
You can't go that way.

>n
Main Hall
You can see servents door and Scotland Yard here.

>w
West wing
Tradtionally the guest bedroom, the west wing is a simply decorated space. The is a great red curtain on the wall you are now facing. To your right is a closet and dressar. They are made of quality oak and seem to impose temselves into the room, as opposed to fitting in with it. The left part of the room contains the guest bed, the bedside table and the reading lamp on top.

* * *

>w
You can't go that way.

>s
You can't go that way.

>w
You can't go that way.

>e
Main Hall
You can see servents door and Scotland Yard here.

>e
(first opening servents door)
It seems to be locked.

>w
West wing
Tradtionally the guest bedroom, the west wing is a simply decorated space. The is a great red curtain on the wall you are now facing. To your right is a closet and dressar. They are made of quality oak and seem to impose temselves into the room, as opposed to fitting in with it. The left part of the room contains the guest bed, the bedside table and the reading lamp on top.

* * *

>s
You can't go that way.

>go to front porch
You can't see any such thing.

* * *

>s
Main Hall
The entrance where visitors are brought. It has an expansive cealing and large woven rugs on a tiled floor. It is here that a representitive of Scotland yard has taken up office. 

You can see a servants door, Suit of armor and Scotland Yard here.

>q
Are you sure you want to quit?

>w
Please answer yes or no.

* * *

>w
West wing

>x
(Closet)
A large oak closet filled with jackets and sweaters. 

In Closet are Jacket and Sweater.

>wear jacket
(first taking Jacket)
You put on Jacket.

>get jacket
You already have that.

>wear sweater
(first taking Sweater)
You put on Sweater.

>i
You are carrying:
  Sweater (being worn)
    Phone number
  Jacket (being worn)

* * *

>s
Main Hall
The entrance where visitors are brought. It has an expansive cealing and large woven rugs on a tiled floor. It is here that a representitive of Scotland yard has taken up office. 

You can see a servants door, Suit of armor and Scotland Yard here.

>a
That's not a verb I recognise.

>s
Grand staircase
The main feature in this room is of course the grand staircase. It has carvings showing the story of the milton family and the beggining of this house. There are images of the ancestors of hte current Milton Family. neat rows of Fuedal lords and Renasiance magistrates. They all have the same stern narrow jawbone.

* * *

>s
Main Hall
The entrance where visitors are brought. It has an expansive cealing and large woven rugs on a tiled floor. It is here that a representitive of Scotland yard has taken up office. 

You can see a servants door, Suit of armor and Scotland Yard here.

>talk to scotland yard
That's not a verb I recognise.

* * *

>victim
You can't see any such thing.

>painting
That's not a verb I recognise.

>ask scotland yard
What do you want to ask Scotland Yard for?

>painting
You can't see any such thing.

>ask scotland yard
What do you want to ask Scotland Yard for?

>suit of armor
(Scotland Yard first taking Suit of armor)
Scotland Yard has better things to do.

>get suit of armor
Taken.

>ask scotland yard about victim
We don't know much. Her name is Jennifer Milton and she was the wife of the late John Milton.

* * *

 Manor
An Interactive Fiction by Phillip Tanton "A woman has been killed at her house, Milton Manor, in the countryside of Cornwall. The local police chief and Scotland yard have had little luck finding the perpatrator. It is your job as the renowned Sherlock Holmes to discover the clues hidden inside the house."
Release 1 / Serial number 141001 / Inform 7 build 6L38 (I6/v6.33 lib 6/12N) SD

Front porch
A simple porch, with two lamps, a reclining chair and a withered old deck.

>get deck
That's hardly portable.

>open deck
It isn't something you can open.

>get code
Taken.

* * *

 Manor
An Interactive Fiction by Phillip Tanton "A woman has been killed at her house, Milton Manor, in the countryside of Cornwall. The local police chief and Scotland yard have had little luck finding the perpatrator. It is your job as the renowned Sherlock Holmes to discover the clues hidden inside the house."
Release 1 / Serial number 141001 / Inform 7 build 6L38 (I6/v6.33 lib 6/12N) SD

Front porch
A simple porch, with two lamps, a reclining chair and a withered old deck.

>l deck
A rotton deck, obiously old and ill maintained. There seems to be part of a paper between two planks.

In Deck is Code.

>get code
Taken.

>s
Main Hall

>s
Grand staircase

>unlock safe
(with Code)
You unlock safe.