 Milton Manor
An Interactive Fiction by Phillip Tanton "A woman has been killed at her house, Milton Manor, in the countryside of Cornwall. The local police chief and Scotland yard have had little luck finding the perpetrator. It is your job as the renowned Sherlock Holmes to discover the clues hidden inside the house. If you find something of interest don't forget to mention it to the representative from Scotland yard."
Release 1 / Serial number 141007 / Inform 7 build 6L38 (I6/v6.33 lib 6/12N) SD

Front porch
A simple porch, with two lamps, a reclining chair and a withered old deck.

>x get all
You can't see any such thing.

>get all
(Code)
Taken.

>s
Main Hall
The entrance where visitors are brought. It has an expansive cealing and large woven rugs on a tiled floor. It is here that a representitive of Scotland yard has taken up office. 

You can see a servants door and Scotland Yard here.

>s
Grand staircase
The main feature in this room is of course the grand staircase. It has carvings showing the story of the milton family and the beggining of this house. There are images of the ancestors of hte current Milton Family. neat rows of Fuedal lords and Renasiance magistrates. They all have the same stern narrow jawbone.

>x painting
A simple painting of "Son of Man", obviolsy a replica but interesting all the same. The edges of the wall seem to be worn. perhaps it is moved around quite often.

>x safe
A heavy safe with a numbered code.

>l painting
A simple painting of "Son of Man", obviolsy a replica but interesting all the same. The edges of the wall seem to be worn. perhaps it is moved around quite often.

>get painting
That's hardly portable.

* * *

 Milton Manor
An Interactive Fiction by Phillip Tanton "A woman has been killed at her house, Milton Manor, in the countryside of Cornwall. The local police chief and Scotland yard have had little luck finding the perpetrator. It is your job as the renowned Sherlock Holmes to discover the clues hidden inside the house. If you find something of interest don't forget to mention it to the representative from Scotland yard."
Release 1 / Serial number 141007 / Inform 7 build 6L38 (I6/v6.33 lib 6/12N) SD

Front porch
A simple porch, with two lamps, a reclining chair and a withered old deck.

>x lamps
You can't see any such thing.

>x lamp
Two antique lamps that glow dimly and flicker with a ambient light.

>take lamp
That's hardly portable.

>x chair
A relaxing chair. It's a dull yellow and looks very comfortable.

>sit in chair
Although it is comfortable to sit here awhile, perhaps you should solve the mystery.

>x deck
A rotten deck, obviously old and ill maintained. There seems to be part of a paper between two planks.

In Deck is Code.

>x code
1539

>take paper
Taken.

>i
You are carrying:
  Code

>s
Main Hall
The entrance where visitors are brought. It has an expansive ceiling and large woven rugs on a tiled floor. It is here that a representative of Scotland yard has taken up office. 

The servants door is a plain wooden door, nothing special.

You can also see Scotland Yard here.

>x yard
You see nothing special about Scotland Yard.

>x representative
You can't see any such thing.

>x door
You see nothing special about the servant's door.

>walk throug door
You can't see any such thing.

>wal through door
That's not a verb I recognise.

>walk through door
(first opening the servant's door)
It seems to be locked.

>n
Front porch
A simple porch, with two lamps, a reclining chair and a withered old deck.

>s
Main Hall
The entrance where visitors are brought. It has an expansive ceiling and large woven rugs on a tiled floor. It is here that a representative of Scotland yard has taken up office. 

The servants door is a plain wooden door, nothing special.

You can also see Scotland Yard here.

>e
(first opening the servant's door)
It seems to be locked.

* * *

 Milton Manor
An Interactive Fiction by Phillip Tanton "A woman has been killed at her house, Milton Manor, in the countryside of Cornwall. The local police chief and Scotland yard have had little luck finding the perpetrator. It is your job as the renowned Sherlock Holmes to discover the clues hidden inside the house. If you find something of interest don't forget to mention it to the representative from Scotland yard."
Release 1 / Serial number 141007 / Inform 7 build 6L38 (I6/v6.33 lib 6/12N) SD

Front porch
A simple porch, with two lamps, a reclining chair and a withered old deck.

>wear claok
You can't see any such thing.

>wear cloak
(first taking Cloak)
You put on Cloak.

>s
Main Hall
The entrance where visitors are brought. It has an expansive cealing and large woven rugs on a tiled floor. It is here that a representitive of Scotland yard has taken up office. 

You can see a servants door and Scotland Yard here.

>w
West wing
Tradtionally the guest bedroom, the west wing is a simply decorated space. The is a great red curtain on the wall you are now facing. To your right is a closet and dressar. They are made of quality oak and seem to impose temselves into the room, as opposed to fitting in with it. The left part of the room contains the guest bed, the bedside table and the reading lamp on top. 

You can see statues here.

>get all
statues: Taken.
Jacket: Taken.
Sweater: Taken.
Phone number: Taken.
Pants: Taken.

>wear sweater
You put on Sweater.

>i
You are carrying:
  Pants
  Phone number
  Sweater (being worn)
  Jacket
  statues
  Cloak (being worn)

>wear jacket
You put on Jacket.

>wear pants
You put on Pants.

>i
You are carrying:
  Pants (being worn)
  Phone number
  Sweater (being worn)
  Jacket (being worn)
  statues
  Cloak (being worn)

>e
Main Hall
The entrance where visitors are brought. It has an expansive cealing and large woven rugs on a tiled floor. It is here that a representitive of Scotland yard has taken up office. 

You can see a servants door and Scotland Yard here.

>i
You are carrying:
  Pants (being worn)
  Phone number
  Sweater (being worn)
  Jacket (being worn)
  statues
  Cloak (being worn)

>n
Front porch
A simple porch, with two lamps, a reclining chair and a withered old deck.

>s
Main Hall
The entrance where visitors are brought. It has an expansive cealing and large woven rugs on a tiled floor. It is here that a representitive of Scotland yard has taken up office. 

You can see a servants door and Scotland Yard here.

>w
West wing
Tradtionally the guest bedroom, the west wing is a simply decorated space. The is a great red curtain on the wall you are now facing. To your right is a closet and dressar. They are made of quality oak and seem to impose temselves into the room, as opposed to fitting in with it. The left part of the room contains the guest bed, the bedside table and the reading lamp on top.

>e
Main Hall
The entrance where visitors are brought. It has an expansive cealing and large woven rugs on a tiled floor. It is here that a representitive of Scotland yard has taken up office. 

You can see a servants door and Scotland Yard here.

>e
(first opening the servants door)
It seems to be locked.

>i
You are carrying:
  Pants (being worn)
  Phone number
  Sweater (being worn)
  Jacket (being worn)
  statues
  Cloak (being worn)

* * *

 Milton Manor
An Interactive Fiction by Phillip Tanton "A woman has been killed at her house, Milton Manor, in the countryside of Cornwall. The local police chief and Scotland yard have had little luck finding the perpetrator. It is your job as the renowned Sherlock Holmes to discover the clues hidden inside the house. If you find something of interest don't forget to mention it to the representative from Scotland yard."
Release 1 / Serial number 141007 / Inform 7 build 6L38 (I6/v6.33 lib 6/12N) SD

Front porch
A simple porch, with two lamps, a reclining chair and a withered old deck.

>give
What do you want to give yourself?

>deck
(to yourself)
(first taking Deck)
That's hardly portable.

>s
Main Hall
The entrance where visitors are brought. It has an expansive cealing and large woven rugs on a tiled floor. It is here that a representitive of Scotland yard has taken up office. 

You can see a servants door and Scotland Yard here.

* * *

>s
Grand staircase
The main feature in this room is of course the grand staircase. It has carvings showing the story of the milton family and the beggining of this house. There are images of the ancestors of hte current Milton Family. neat rows of Fuedal lords and Renasiance magistrates. They all have the same stern narrow jawbone.

>give
(yourself painting)
(first taking painting)
That's hardly portable.

>give necklace
You can't see any such thing.

>give all
(yourself painting)
(first taking painting)
That's hardly portable.

* * *

 Milton Manor
An Interactive Fiction by Phillip Tanton "A woman has been killed at her house, Milton Manor, in the countryside of Cornwall. The local police chief and Scotland yard have had little luck finding the perpetrator. It is your job as the renowned Sherlock Holmes to discover the clues hidden inside the house. If you find something of interest don't forget to mention it to the representative from Scotland yard."
Release 1 / Serial number 141007 / Inform 7 build 6L38 (I6/v6.33 lib 6/12N) SD

Front porch
A simple porch, with two lamps, a reclining chair and a withered old deck.

>south
Main Hall
The entrance where visitors are brought. It has an expansive cealing and large woven rugs on a tiled floor. It is here that a representitive of Scotland yard has taken up office. 

The servants door is a plain wooden door, nothing special.

You can also see Scotland Yard here.

>east
(first opening the servant's door)
It seems to be locked.

>west
West wing
Traditionally the guest bedroom, the west wing is a simply decorated space. There is a great red curtain on the wall you are now facing. To your right is a closet and dresser. They are made of quality oak and seem to impose themselves into the room, as opposed to fitting in with it. The parts of the room to your left contain the guest bed, the bedside table and the reading lamp on top. There is also a bedroom mirror on the door.

>xcurtain
That's not a verb I recognise.

>x curtain
You see nothing special about Red curtain.

>x closet
A large oak closet filled with jackets and sweaters. 

In Closet are Jacket and Sweater.

>x jacket
You see nothing special about Jacket.

>x sweater
In Sweater is Phone number.

>x phone number
 44 (302) 866 5738

>put on
What do you want to put on?

>put on sweater
(first taking Sweater)
You put on Sweater.

>talk
(to Sweater)
Try asking  about something instead.

>ask sweater
You can only do that to something animate.

>east
Main Hall
The entrance where visitors are brought. It has an expansive cealing and large woven rugs on a tiled floor. It is here that a representitive of Scotland yard has taken up office. 

The servants door is a plain wooden door, nothing special.

You can also see Scotland Yard here.

>ask scotland yard
(for Sweater)
(Scotland Yard first taking Sweater)
Scotland Yard has better things to do.

>ask scotland yard about phone number
Thank you so much, we will look into this right away .... Ok ....  The number is atrributed to two men. Why don't you give us the phone number.

>give phone number
(to Scotland Yard)
(first taking Phone number)
Thank you

>north
Front porch
A simple porch, with two lamps, a reclining chair and a withered old deck.

>south
Main Hall
The entrance where visitors are brought. It has an expansive cealing and large woven rugs on a tiled floor. It is here that a representitive of Scotland yard has taken up office. 

The servants door is a plain wooden door, nothing special.

You can also see Scotland Yard here.

>south
Grand staircase
The main feature in this room is of course the grand staircase. It has carvings showing the story of the milton family and the beginning of this house. There are images of the ancestors of the current Milton Family. neat rows of Fuedal lords and Renasiance magistrates. They all have the same stern narrow jawbone. There is also a painting in the corner of the room. It seems a bit our of the way.

>x painting
A simple painting of "Son of Man", obviolsy a replica but interesting all the same. The edges of the wall seem to be worn. perhaps it is moved around quite often.

>x wall
You can't see any such thing.

>x edges of the wall
You can't see any such thing.

>north
Main Hall
The entrance where visitors are brought. It has an expansive cealing and large woven rugs on a tiled floor. It is here that a representitive of Scotland yard has taken up office. 

The servants door is a plain wooden door, nothing special.

You can also see Scotland Yard here.

>south
Grand staircase
The main feature in this room is of course the grand staircase. It has carvings showing the story of the milton family and the beginning of this house. There are images of the ancestors of the current Milton Family. neat rows of Fuedal lords and Renasiance magistrates. They all have the same stern narrow jawbone. There is also a painting in the corner of the room. It seems a bit our of the way.

>south
Master Bedroom
The keep of this castle. It a heavily furnished room, one large rug on the bottom and two quilts hanging. Both contain war scenes. One is about a man holding off the enemy at a bridge, while his comrades escape and destroy the bridge behind him.

>x quilts
You can't see any such thing.

>x rug
You can't see any such thing.

>north
Grand staircase
The main feature in this room is of course the grand staircase. It has carvings showing the story of the milton family and the beginning of this house. There are images of the ancestors of the current Milton Family. neat rows of Fuedal lords and Renasiance magistrates. They all have the same stern narrow jawbone. There is also a painting in the corner of the room. It seems a bit our of the way.

>south
Master Bedroom
The keep of this castle. It a heavily furnished room, one large rug on the bottom and two quilts hanging. Both contain war scenes. One is about a man holding off the enemy at a bridge, while his comrades escape and destroy the bridge behind him.

>south
You can't go that way.

>west
You can't go that way.

>east
You can't go that way.

>north
Grand staircase
The main feature in this room is of course the grand staircase. It has carvings showing the story of the milton family and the beginning of this house. There are images of the ancestors of the current Milton Family. neat rows of Fuedal lords and Renasiance magistrates. They all have the same stern narrow jawbone. There is also a painting in the corner of the room. It seems a bit our of the way.

* * *

>south
Master Bedroom
The keep of this castle. It a heavily furnished room, one large rug on the bottom and two quilts hanging. Both contain war scenes. One is about a man holding off the enemy at a bridge, while his comrades escape and destroy the bridge behind him.

>north
Grand staircase
The main feature in this room is of course the grand staircase. It has carvings showing the story of the milton family and the beginning of this house. There are images of the ancestors of the current Milton Family. neat rows of Fuedal lords and Renasiance magistrates. They all have the same stern narrow jawbone. There is also a painting in the corner of the room. It seems a bit our of the way.

>north
Main Hall
The entrance where visitors are brought. It has an expansive cealing and large woven rugs on a tiled floor. It is here that a representitive of Scotland yard has taken up office. 

The servants door is a plain wooden door, nothing special.

You can also see Scotland Yard here.

>east
(first opening the servant's door)
It seems to be locked.

>x door
You see nothing special about the servant's door.

>south
Grand staircase
The main feature in this room is of course the grand staircase. It has carvings showing the story of the milton family and the beginning of this house. There are images of the ancestors of the current Milton Family. neat rows of Fuedal lords and Renasiance magistrates. They all have the same stern narrow jawbone. There is also a painting in the corner of the room. It seems a bit our of the way.

>north
Main Hall
The entrance where visitors are brought. It has an expansive cealing and large woven rugs on a tiled floor. It is here that a representitive of Scotland yard has taken up office. 

The servants door is a plain wooden door, nothing special.

You can also see Scotland Yard here.

>west
West wing
Traditionally the guest bedroom, the west wing is a simply decorated space. There is a great red curtain on the wall you are now facing. To your right is a closet and dresser. They are made of quality oak and seem to impose themselves into the room, as opposed to fitting in with it. The parts of the room to your left contain the guest bed, the bedside table and the reading lamp on top. There is also a bedroom mirror on the door.

>x bed
You can't see any such thing.

>east
Main Hall
The entrance where visitors are brought. It has an expansive cealing and large woven rugs on a tiled floor. It is here that a representitive of Scotland yard has taken up office. 

The servants door is a plain wooden door, nothing special.

You can also see Scotland Yard here.

>north
Front porch
A simple porch, with two lamps, a reclining chair and a withered old deck.

>x deck
A rotton deck, obiously old and ill maintained. There seems to be part of a paper between two planks.

In Deck is Code.

>x code
1539

>south
Main Hall
The entrance where visitors are brought. It has an expansive cealing and large woven rugs on a tiled floor. It is here that a representitive of Scotland yard has taken up office. 

The servants door is a plain wooden door, nothing special.

You can also see Scotland Yard here.

>ask scotland yard
(for Sweater)
(Scotland Yard first taking Sweater)
Scotland Yard has better things to do.

>ask scotland yard about code
Mabye it is a code for a lock.

>south
Grand staircase
The main feature in this room is of course the grand staircase. It has carvings showing the story of the milton family and the beginning of this house. There are images of the ancestors of the current Milton Family. neat rows of Fuedal lords and Renasiance magistrates. They all have the same stern narrow jawbone. There is also a painting in the corner of the room. It seems a bit our of the way.

* * *

>east
(first opening the servant's door)
It seems to be locked.

>code 1539
That's not a verb I recognise.

>south
Grand staircase
The main feature in this room is of course the grand staircase. It has carvings showing the story of the milton family and the beginning of this house. There are images of the ancestors of the current Milton Family. neat rows of Fuedal lords and Renasiance magistrates. They all have the same stern narrow jawbone. There is also a painting in the corner of the room. It seems a bit our of the way.

* * *

>x painting
A simple painting of "Son of Man", obviolsy a replica but interesting all the same. The edges of the wall seem to be worn. perhaps it is moved around quite often.

>x edge of wall
You can't see any such thing.

>open wall
You can't see any such thing.

>open
(Sweater)
It isn't something you can open.

>open painting
You open painting, revealing safe.

>type code
That's not a verb I recognise.

>i
You are carrying:
  Sweater (being worn)

>dial
That's not a verb I recognise.

>examine safe
A heavy safe in the wall with a numbered code. You have to SPIN the dial to one number to open it.

>spin dial
I didn't understand that sentence.

>spin dial to 1
You hear a gentle click but when you go to open the safe is does not open. Try again.

>spin dial to 1539
finally the handle opens and you have uncovered the necklace that was inside.

>x necklace
A pretty pearl necklace. It is endowned with green gems. Mabye the perpatrater touched it and left some fingerprints. there suit of armor

>take necklace
Taken.

>x suit of armor
You can't see any such thing.

>x armor
You can't see any such thing.

>south
Master Bedroom
The keep of this castle. It a heavily furnished room, one large rug on the bottom and two quilts hanging. Both contain war scenes. One is about a man holding off the enemy at a bridge, while his comrades escape and destroy the bridge behind him.

* * *

>north
Main Hall
The entrance where visitors are brought. It has an expansive cealing and large woven rugs on a tiled floor. It is here that a representitive of Scotland yard has taken up office. 

The servants door is a plain wooden door, nothing special.

You can also see Scotland Yard here.

>ask scotland yard about necklace
I will take this and run it for fin gerprints. ... And there is a partial ... There are 3 matches. Why don't you give this to us for safekeeping.

>give
What do you want to give Scotland Yard?

>give necklace
(to Scotland Yard)
Thank you for this. We'll keep it safe

    *** you have found the culprit using your wits and logic. You have done a good job.  ***

Would you like to RESTART, RESTORE a saved game, QUIT or UNDO the last command?

* * *

>south
Main Hall
The entrance where visitors are brought. It has an expansive cealing and large woven rugs on a tiled floor. It is here that a representitive of Scotland yard has taken up office. 

The servants door is a plain wooden door, nothing special.

You can also see Scotland Yard here.

>west
West wing
Traditionally the guest bedroom, the west wing is a simply decorated space. There is a great red curtain on the wall you are now facing. To your right is a closet and dresser. They are made of quality oak and seem to impose themselves into the room, as opposed to fitting in with it. The parts of the room to your left contain the guest bed, the bedside table and the reading lamp on top. There is also a bedroom mirror on the door.

>x closet
A large oak closet filled with jackets and sweaters. 

In Closet are Jacket and Sweater.

>x sweater
In Sweater is Phone number.

* * *

>x phone number
 44 (302) 866 5738

>take phone number
Taken.

>east
Main Hall
The entrance where visitors are brought. It has an expansive cealing and large woven rugs on a tiled floor. It is here that a representitive of Scotland yard has taken up office. 

The servants door is a plain wooden door, nothing special.

You can also see Scotland Yard here.

>ask scotland yard
(for Phone number)
(Scotland Yard first taking Phone number)
Scotland Yard has better things to do.

>give phone number
(to Scotland Yard)
Thank you

>south
Grand staircase
The main feature in this room is of course the grand staircase. It has carvings showing the story of the milton family and the beginning of this house. There are images of the ancestors of the current Milton Family. neat rows of Fuedal lords and Renasiance magistrates. They all have the same stern narrow jawbone. There is also a painting in the corner of the room. It seems a bit our of the way.

* * *

>x wall
You can't see any such thing.

>inspect wall
That's not a verb I recognise.

>take painting
That's hardly portable.

>open painting
You open painting, revealing safe.

>open safe
the safe only opens when the dial is turned to the correct number.

>south
Master Bedroom
The keep of this castle. It a heavily furnished room, one large rug on the bottom and two quilts hanging. Both contain war scenes. One is about a man holding off the enemy at a bridge, while his comrades escape and destroy the bridge behind him.

>west
You can't go that way.

>north
Grand staircase
The main feature in this room is of course the grand staircase. It has carvings showing the story of the milton family and the beginning of this house. There are images of the ancestors of the current Milton Family. neat rows of Fuedal lords and Renasiance magistrates. They all have the same stern narrow jawbone. There is also a painting in the corner of the room. It seems a bit our of the way.

>west
You can't go that way.

>south
Master Bedroom
The keep of this castle. It a heavily furnished room, one large rug on the bottom and two quilts hanging. Both contain war scenes. One is about a man holding off the enemy at a bridge, while his comrades escape and destroy the bridge behind him.

* * *

>west
West wing
Traditionally the guest bedroom, the west wing is a simply decorated space. There is a great red curtain on the wall you are now facing. To your right is a closet and dresser. They are made of quality oak and seem to impose themselves into the room, as opposed to fitting in with it. The parts of the room to your left contain the guest bed, the bedside table and the reading lamp on top. There is also a bedroom mirror on the door.

>east
Main Hall
The entrance where visitors are brought. It has an expansive cealing and large woven rugs on a tiled floor. It is here that a representitive of Scotland yard has taken up office. 

The servants door is a plain wooden door, nothing special.

You can also see Scotland Yard here.

* * *

>x code
1539

>take code
Taken.

>south
Main Hall
The entrance where visitors are brought. It has an expansive cealing and large woven rugs on a tiled floor. It is here that a representitive of Scotland yard has taken up office. 

The servants door is a plain wooden door, nothing special.

You can also see Scotland Yard here.

* * *

>south
Grand staircase
The main feature in this room is of course the grand staircase. It has carvings showing the story of the milton family and the beginning of this house. There are images of the ancestors of the current Milton Family. neat rows of Fuedal lords and Renasiance magistrates. They all have the same stern narrow jawbone. There is also a painting in the corner of the room. It seems a bit our of the way.

>x painting
A simple painting of "Son of Man", obviolsy a replica but interesting all the same. The edges of the wall seem to be worn. perhaps it is moved around quite often.

In painting is safe.

>open painting
That's already open.

>x safe
A heavy safe in the wall with a numbered code. You have to SPIN the dial to one number to open it.

>spin dial
I didn't understand that sentence.

>spin 1
You can't see any such thing.

>dial 1
That's not a verb I recognise.

>spin dial to 1
You hear a gentle click but when you go to open the safe is does not open. Try again.

* * *

>spin dial to 1539
finally the handle opens and you have uncovered the necklace that was inside.

>take necklace
Taken.

>south
Master Bedroom
The keep of this castle. It a heavily furnished room, one large rug on the bottom and two quilts hanging. Both contain war scenes. One is about a man holding off the enemy at a bridge, while his comrades escape and destroy the bridge behind him.

* * *

>north
Main Hall
The entrance where visitors are brought. It has an expansive cealing and large woven rugs on a tiled floor. It is here that a representitive of Scotland yard has taken up office. 

The servants door is a plain wooden door, nothing special.

You can also see Scotland Yard here.

>ask scotland yard
What do you want to ask Scotland Yard for?

>give scotland yard necklace
Thank you for this. We'll keep it safe

    *** you have found the culprit using your wits and logic. You have done a good job.  ***

Would you like to RESTART, RESTORE a saved game, QUIT or UNDO the last command?

* * *

>give
What do you want to give yourself?

>code
(to yourself)
(first taking Code)
You can't give Code to yourself.

>i
You are carrying:
  Code

>give
(yourself Code)
You can't give Code to yourself.

>deck
That's not a verb I recognise.

* * *

 Milton Manor
An Interactive Fiction by Phillip Tanton "A woman has been killed at her house, Milton Manor, in the countryside of Cornwall. The local police chief and Scotland yard have had little luck finding the perpetrator. It is your job as the renowned Sherlock Holmes to discover the clues hidden inside the house. If you find something of interest don't forget to mention it to the representative from Scotland yard."
Release 1 / Serial number 141007 / Inform 7 build 6L38 (I6/v6.33 lib 6/12N) SD

Front porch
A simple porch, with two lamps, a reclining chair and a withered old deck.

>North
You can't go that way.

>South
Main Hall
The entrance where visitors are brought. It has an expansive cealing and large woven rugs on a tiled floor. It is here that a representitive of Scotland yard has taken up office. 

The servants door is a plain wooden door, nothing special.

You can also see Scotland Yard here.

>w
West wing
Tradtionally the guest bedroom, the west wing is a simply decorated space. There is a great red curtain on the wall you are now facing. To your right is a closet and dresser. They are made of quality oak and seem to impose themselves into the room, as opposed to fitting in with it. The parts of the room to your left contain the guest bed, the bedside table and the reading lamp on top. There is also a bedroom mirror on the door.

>e
Main Hall
The entrance where visitors are brought. It has an expansive cealing and large woven rugs on a tiled floor. It is here that a representitive of Scotland yard has taken up office. 

The servants door is a plain wooden door, nothing special.

You can also see Scotland Yard here.

>e
(first opening the servant's door)
It seems to be locked.

>unlock
What do you want to unlock?

>servant door
You can't see any such thing.

>servant'sdoor
That's not a verb I recognise.

* * *

 Milton Manor
An Interactive Fiction by Phillip Tanton "A woman has been killed at her house, Milton Manor, in the countryside of Cornwall. The local police chief and Scotland yard have had little luck finding the perpetrator. It is your job as the renowned Sherlock Holmes to discover the clues hidden inside the house. If you find something of interest don't forget to mention it to the representative from Scotland yard."
Release 1 / Serial number 141007 / Inform 7 build 6L38 (I6/v6.33 lib 6/12N) SD

Front porch
A simple porch, with two lamps, a reclining chair and a withered old deck.

>s
Main Hall
The entrance where visitors are brought. It has an expansive cealing and large woven rugs on a tiled floor. It is here that a representitive of Scotland yard has taken up office. 

The servants door is a plain wooden door, nothing special.

You can also see Scotland Yard here.

I beg your pardon?

>s
Grand staircase
The main feature in this room is of course the grand staircase. It has carvings showing the story of the milton family and the beggining of this house. There are images of the ancestors of the current Milton Family. neat rows of Fuedal lords and Renasiance magistrates. They all have the same stern narrow jawbone.

>open painting
You open painting, revealing safe.

>turn dial to 1539
I only understood you as far as wanting to turn safe.

* * *

>s
Main Hall
The entrance where visitors are brought. It has an expansive cealing and large woven rugs on a tiled floor. It is here that a representitive of Scotland yard has taken up office. 

The servants door is a plain wooden door, nothing special.

You can also see Scotland Yard here.

>w
West wing
Traditionally the guest bedroom, the west wing is a simply decorated space. There is a great red curtain on the wall you are now facing. To your right is a closet and dresser. They are made of quality oak and seem to impose themselves into the room, as opposed to fitting in with it. The parts of the room to your left contain the guest bed, the bedside table and the reading lamp on top. There is also a bedroom mirror on the door.

>take phone number
You can't see any such thing.

>open closet
You open Closet, revealing Jacket and Sweater.

* * *

>s
Main Hall
The entrance where visitors are brought. It has an expansive cealing and large woven rugs on a tiled floor. It is here that a representitive of Scotland yard has taken up office. 

The servants door is a plain wooden door, nothing special.

You can also see Scotland Yard here.

>s
Grand staircase
The main feature in this room is of course the grand staircase. It has carvings showing the story of the milton family and the beginning of this house. There are images of the ancestors of the current Milton Family. neat rows of Fuedal lords and Renasiance magistrates. They all have the same stern narrow jawbone. There is also a painting in the corner of the room. It seems a bit our of the way.

>s
Master Bedroom
The keep of this castle. It a heavily furnished room, one large rug on the bottom and two quilts hanging. Both contain war scenes. One is about a man holding off the enemy at a bridge, while his comrades escape and destroy the bridge behind him.

>s
You can't go that way.

>n
Grand staircase
The main feature in this room is of course the grand staircase. It has carvings showing the story of the milton family and the beginning of this house. There are images of the ancestors of the current Milton Family. neat rows of Fuedal lords and Renasiance magistrates. They all have the same stern narrow jawbone. There is also a painting in the corner of the room. It seems a bit our of the way.

>n
Main Hall
The entrance where visitors are brought. It has an expansive cealing and large woven rugs on a tiled floor. It is here that a representitive of Scotland yard has taken up office. 

The servants door is a plain wooden door, nothing special.

You can also see Scotland Yard here.

>w
West wing
Tradtionally the guest bedroom, the west wing is a simply decorated space. There is a great red curtain on the wall you are now facing. To your right is a closet and dresser. They are made of quality oak and seem to impose themselves into the room, as opposed to fitting in with it. The parts of the room to your left contain the guest bed, the bedside table and the reading lamp on top. There is also a bedroom mirror on the door.

A nicly woven curtain. It looks old and dusty although it seems to have been taken care of and is not much deterioration.

You can also see Mirror and statues here.

>i
You are carrying nothing.

>i
You are carrying nothing.

* * *

>s
Grand staircase
The main feature in this room is of course the grand staircase. It has carvings showing the story of the milton family and the beginning of this house. There are images of the ancestors of the current Milton Family. neat rows of Fuedal lords and Renasiance magistrates. They all have the same stern narrow jawbone. There is also a painting in the corner of the room. It seems a bit our of the way.

>open painting
You open painting, revealing safe.

>spin dial to 1539
finally the handle opens and you have uncovered the necklace that was inside.

* * *

>take necklace
Taken.

>w
You can't go that way.

>n
Main Hall
The entrance where visitors are brought. It has an expansive cealing and large woven rugs on a tiled floor. It is here that a representitive of Scotland yard has taken up office. 

The servants door is a plain wooden door, nothing special.

You can also see Scotland Yard here.

>w
West wing
Traditionally the guest bedroom, the west wing is a simply decorated space. There is a great red curtain on the wall you are now facing. To your right is a closet and dresser. They are made of quality oak and seem to impose themselves into the room, as opposed to fitting in with it. The parts of the room to your left contain the guest bed, the bedside table and the reading lamp on top. There is also a bedroom mirror on the door.

>x mirrror
You can't see any such thing.

>x mirror
you can see from here Red curtain in the mirror.

>x mirror
you can see from here Closet in the mirror.

* * *

>open painting
You open painting, revealing safe.

>spin safe to 1539
finally the handle opens and you have uncovered the necklace that was inside.

* * *

 Milton Manor
An Interactive Fiction by Phillip Tanton "A woman has been killed at her house, Milton Manor, in the countryside of Cornwall. The local police chief and Scotland yard have had little luck finding the perpetrator. It is your job as the renowned Sherlock Holmes to discover the clues hidden inside the house. If you find something of interest don't forget to mention it to the representative from Scotland yard."
Release 1 / Serial number 141007 / Inform 7 build 6L38 (I6/v6.33 lib 6/12N) SD

Front porch
A simple porch, with two lamps, a reclining chair and a withered old deck.

>x porch
You can't see any such thing.

>x lamps
You can't see any such thing.

>x chair
A relaxing chair. It's a dull yellow and looks very comfortable.

>sit in chair
That's not something you can sit down on.

>sit on chair
That's not something you can sit down on.

>x deck
A rotton deck, obiously old and ill maintained. There seems to be part of a paper between two planks.

In Deck is Code.

>x paper
You can't see any such thing.

>take paper
You can't see any such thing.

>take part of a paper
You can't see any such thing.

>x planks
You can't see any such thing.

>s
Main Hall
The entrance where visitors are brought. It has an expansive cealing and large woven rugs on a tiled floor. It is here that a representitive of Scotland yard has taken up office. 

You can see a servants door and Scotland Yard here.

>n
Front porch
A simple porch, with two lamps, a reclining chair and a withered old deck.

You can see Cloak here.

>take code
Taken.

>x code
50-39-18

>x cloak
You see nothing special about Cloak.

>take cloak
Taken.

>wear cloak
You put on Cloak.

>s
Main Hall
The entrance where visitors are brought. It has an expansive cealing and large woven rugs on a tiled floor. It is here that a representitive of Scotland yard has taken up office. 

You can see a servants door and Scotland Yard here.

>x servants
You see nothing special about the servants door.

>x scotland yard
You see nothing special about Scotland Yard.

>talk to scotland yard
Try asking  about something instead.

>ask scotland yard about woman
There is no reply.

>open door
It seems to be locked.

>w
West wing
Tradtionally the guest bedroom, the west wing is a simply decorated space. The is a great red curtain on the wall you are now facing. To your right is a closet and dressar. They are made of quality oak and seem to impose temselves into the room, as opposed to fitting in with it. The left part of the room contains the guest bed, the bedside table and the reading lamp on top. 

You can see statues here.

>x dressar
You can't see any such thing.

>x closet
A large oak closet filled with jackets and sweaters. 

In Closet are Jacket and Sweater.

* * *

>x phone number
 44 (302) 866 5738

>take paper
You can't see any such thing.

>e
Main Hall
The entrance where visitors are brought. It has an expansive cealing and large woven rugs on a tiled floor. It is here that a representitive of Scotland yard has taken up office. 

You can see a servants door and Scotland Yard here.

>w
West wing
Tradtionally the guest bedroom, the west wing is a simply decorated space. The is a great red curtain on the wall you are now facing. To your right is a closet and dressar. They are made of quality oak and seem to impose temselves into the room, as opposed to fitting in with it. The left part of the room contains the guest bed, the bedside table and the reading lamp on top. 

You can see statues here.

>take  phone number
Taken.

>x guest bed
You can't see any such thing.

>x curtain
You can't see any such thing.

>x table
You can't see any such thing.

>x lamp
You can't see any such thing.

>e
Main Hall
The entrance where visitors are brought. It has an expansive cealing and large woven rugs on a tiled floor. It is here that a representitive of Scotland yard has taken up office. 

You can see a servants door and Scotland Yard here.

>ask scotland yard about phone number
Thank you so much, we will look into this right away .... Ok ....  The number is atrributed to two men. Why don't you give us the phone number.

>i
You are carrying:
  Phone number
  Cloak (being worn)
  Code

* * *

>x porch
You can't see any such thing.

>lamps
That's not a verb I recognise.

>x lamps
You can't see any such thing.

* * *

>x chair
A relaxing chair. It's a dull yellow and looks very comfortable.

>x deck
A rotton deck, obiously old and ill maintained. There seems to be part of a paper between two planks.

In Deck is Code.

>take code
Taken.

* * *

>x code
50-39-18

>s
Main Hall
The entrance where visitors are brought. It has an expansive cealing and large woven rugs on a tiled floor. It is here that a representitive of Scotland yard has taken up office. 

You can see a servants door, Suit of armor and Scotland Yard here.

>x suit of armor
A medival style suit-of-armor. It looks as if it is greased on a regular basis, for there is no rust and it still shines.

>take armor
Taken.

>wear armor
You can't wear that!

>x scotland yard
You see nothing special about Scotland Yard.

>talk to scotland yard
That's not a verb I recognise.

>talk to scotland yard
That's not a verb I recognise.

>ask scotland yard
What do you want to ask Scotland Yard for?

>victim
You can't see any such thing.

>ask scotland yard about victim
We don't know much. Her name is Jennifer Milton and she was the wife of the late John Milton.

* * *

>x porch
You can't see any such thing.

>x two lamps
You can't use multiple objects with that verb.

>x lamp
Two antique lamps that glow dimly and flicker with a ambiant light.

>x reclining chair
A relaxing chair. It's a dull yellow and looks very comfortable.

>x withered old deck
You can't see any such thing.

>sit reclining chair
I didn't understand that sentence.

>sit in the reclining chair
Although it is comfortable to sit here awhile, perhaps you shuold solve the mystery.

>look at withered old deck
You can't see any such thing.

>north
You can't go that way.

>south
Main Hall
The entrance where visitors are brought. It has an expansive cealing and large woven rugs on a tiled floor. It is here that a representitive of Scotland yard has taken up office. 

Persian rugs, made of the higest quality. The purpose is simple, to show off the extravagent lifestyle of the miltons.

You can also see a servant's door and Scotland Yard here.

>x servant's door
You see nothing special about the servant's door.

>north
Front porch
A simple porch, with two lamps, a reclining chair and a withered old deck.

>south
Main Hall
The entrance where visitors are brought. It has an expansive cealing and large woven rugs on a tiled floor. It is here that a representitive of Scotland yard has taken up office. 

Persian rugs, made of the higest quality. The purpose is simple, to show off the extravagent lifestyle of the miltons.

You can also see a servant's door and Scotland Yard here.

>west
West wing
Tradtionally the guest bedroom, the west wing is a simply decorated space. There is a great red curtain on the wall you are now facing. To your right is a closet and dresser. They are made of quality oak and seem to impose temselves into the room, as opposed to fitting in with it. The parts of the room to your left contain the guest bed, the bedside table and the reading lamp on top. There is also a bedroom mirror on the door.

A nicly woven curtain. It looks old and dusty although it seems to have been taken care of and is not much deterioration.

You can also see Mirror and statues here.

>x mirror
you can see from here Phone number in the mirror.

>take phone number
Taken.

>take house
You can't see any such thing.

>take guest bedroom
You can't see any such thing.

>x closet
A large oak closet filled with jackets and sweaters. 

In Closet are Jacket and Sweater.

* * *

>x jacket
You see nothing special about Jacket.

>x sweater
Sweater is empty.

>x dresser
a classic dresser with three drawers and some figurines on top. The wood working is of the highest quality and the caprpenter coate the dresser in varnish so that it could shine.

>east
Main Hall
The entrance where visitors are brought. It has an expansive cealing and large woven rugs on a tiled floor. It is here that a representitive of Scotland yard has taken up office. 

Persian rugs, made of the higest quality. The purpose is simple, to show off the extravagent lifestyle of the miltons.

You can also see a servant's door and Scotland Yard here.

>east
(first opening the servant's door)
It seems to be locked.

>is it the servant
That's not a verb I recognise.

>south
Grand staircase
The main feature in this room is of course the grand staircase. It has carvings showing the story of the milton family and the beggining of this house. There are images of the ancestors of the current Milton Family. neat rows of Fuedal lords and Renasiance magistrates. They all have the same stern narrow jawbone.

>north
Main Hall
The entrance where visitors are brought. It has an expansive cealing and large woven rugs on a tiled floor. It is here that a representitive of Scotland yard has taken up office. 

Persian rugs, made of the higest quality. The purpose is simple, to show off the extravagent lifestyle of the miltons.

You can also see a servant's door and Scotland Yard here.

>south
Grand staircase
The main feature in this room is of course the grand staircase. It has carvings showing the story of the milton family and the beggining of this house. There are images of the ancestors of the current Milton Family. neat rows of Fuedal lords and Renasiance magistrates. They all have the same stern narrow jawbone.

>south
Master Bedroom
The keep of this castle. It a heavily furnished room, one large rug on the bottom and two quilts hanging. Both contain war scenes. One is about a man holding off the enemy at a bridge, while his comrades escape and destroy the bridge behind him.

>x master bedroom
You can't see any such thing.

>take master bedroom
You can't see any such thing.

>take persian rugs
You can't see any such thing.

>l
Master Bedroom
The keep of this castle. It a heavily furnished room, one large rug on the bottom and two quilts hanging. Both contain war scenes. One is about a man holding off the enemy at a bridge, while his comrades escape and destroy the bridge behind him.

>l west wing
I only understood you as far as wanting to look west.

>west
You can't go that way.

>north
Grand staircase
The main feature in this room is of course the grand staircase. It has carvings showing the story of the milton family and the beggining of this house. There are images of the ancestors of the current Milton Family. neat rows of Fuedal lords and Renasiance magistrates. They all have the same stern narrow jawbone.

>north
Main Hall
The entrance where visitors are brought. It has an expansive cealing and large woven rugs on a tiled floor. It is here that a representitive of Scotland yard has taken up office. 

Persian rugs, made of the higest quality. The purpose is simple, to show off the extravagent lifestyle of the miltons.

You can also see a servant's door and Scotland Yard here.

>take large woven rug
You can't see any such thing.

>sit woven rug
I didn't understand that sentence.

>spin
I didn't understand that sentence.

>spin the bottle
You can't see any such thing.

>east
(first opening the servant's door)
It seems to be locked.

>unlock
(Phone number with Phone number)
That doesn't seem to be something you can unlock.

>east
(first opening the servant's door)
It seems to be locked.

>north
Front porch
A simple porch, with two lamps, a reclining chair and a withered old deck.

>x withered old deck
You can't see any such thing.

>l
Front porch
A simple porch, with two lamps, a reclining chair and a withered old deck.

>examine deck
A rotton deck, obiously old and ill maintained. There seems to be part of a paper between two planks.

In Deck is Code.

>unlock
(Phone number with Phone number)
That doesn't seem to be something you can unlock.

>take code
Taken.

>norht
That's not a verb I recognise.

>north
You can't go that way.

* * *

>south
Main Hall
The entrance where visitors are brought. It has an expansive cealing and large woven rugs on a tiled floor. It is here that a representitive of Scotland yard has taken up office. 

Persian rugs, made of the higest quality. The purpose is simple, to show off the extravagent lifestyle of the miltons.

You can also see a servant's door and Scotland Yard here.

>south
Grand staircase
The main feature in this room is of course the grand staircase. It has carvings showing the story of the milton family and the beggining of this house. There are images of the ancestors of the current Milton Family. neat rows of Fuedal lords and Renasiance magistrates. They all have the same stern narrow jawbone.

>x grand staircase
You can't see any such thing.

>x image
You can't see any such thing.

>take image
You can't see any such thing.

I beg your pardon?

>l
Grand staircase
The main feature in this room is of course the grand staircase. It has carvings showing the story of the milton family and the beggining of this house. There are images of the ancestors of the current Milton Family. neat rows of Fuedal lords and Renasiance magistrates. They all have the same stern narrow jawbone.

>north
Main Hall
The entrance where visitors are brought. It has an expansive cealing and large woven rugs on a tiled floor. It is here that a representitive of Scotland yard has taken up office. 

Persian rugs, made of the higest quality. The purpose is simple, to show off the extravagent lifestyle of the miltons.

You can also see a servant's door and Scotland Yard here.

* * *

>south
Grand staircase
The main feature in this room is of course the grand staircase. It has carvings showing the story of the milton family and the beggining of this house. There are images of the ancestors of the current Milton Family. neat rows of Fuedal lords and Renasiance magistrates. They all have the same stern narrow jawbone.

>examine painting
A simple painting of "Son of Man", obviolsy a replica but interesting all the same. The edges of the wall seem to be worn. perhaps it is moved around quite often.

>take painting
That's hardly portable.

>move painting
It is fixed in place.

>unlcok
That's not a verb I recognise.

>open
What do you want to open?

>painting
You open painting, revealing safe.

>unlock
What do you want to unlock?

>safe
What do you want to unlock safe with?

>code
That doesn't seem to be something you can unlock.

>phone number
That's not a verb I recognise.

>x code
1539

>1539
That's not a verb I recognise.

>open
What do you want to open?

>safe
the safe only opens when the dial is turned to the correct number.

>1539
That's not a verb I recognise.

* * *

>safe
the safe only opens when the dial is turned to the correct number.

>spin
What do you want to spin?

>dial to 1539
finally the handle opens and you have uncovered the necklace that was inside.

>take necklace
Taken.

>it was the jews
That's not a verb I recognise.

>south
Master Bedroom
The keep of this castle. It a heavily furnished room, one large rug on the bottom and two quilts hanging. Both contain war scenes. One is about a man holding off the enemy at a bridge, while his comrades escape and destroy the bridge behind him.

* * *

>south
You can't go that way.

>north
Grand staircase
The main feature in this room is of course the grand staircase. It has carvings showing the story of the milton family and the beggining of this house. There are images of the ancestors of the current Milton Family. neat rows of Fuedal lords and Renasiance magistrates. They all have the same stern narrow jawbone.

* * *

>north
Main Hall
The entrance where visitors are brought. It has an expansive cealing and large woven rugs on a tiled floor. It is here that a representitive of Scotland yard has taken up office. 

Persian rugs, made of the higest quality. The purpose is simple, to show off the extravagent lifestyle of the miltons.

You can also see a servant's door and Scotland Yard here.

>north
Front porch
A simple porch, with two lamps, a reclining chair and a withered old deck.

* * *

>south
Main Hall
The entrance where visitors are brought. It has an expansive cealing and large woven rugs on a tiled floor. It is here that a representitive of Scotland yard has taken up office. 

Persian rugs, made of the higest quality. The purpose is simple, to show off the extravagent lifestyle of the miltons.

You can also see a servant's door and Scotland Yard here.

>scotland yard
That's not a verb I recognise.

>Talk to Scotland Yard
Try asking  about something instead.

>Ask Scotland Yard
What do you want to ask Scotland Yard for?

>clues
You can't see any such thing.

>Ask Scotland Yard
What do you want to ask Scotland Yard for?

>necklace
(Scotland Yard first taking Necklace)
Scotland Yard has better things to do.

>phone number
That's not a verb I recognise.

>Ask Scotland Yard
What do you want to ask Scotland Yard for?

>phone number
(Scotland Yard first taking Phone number)
Scotland Yard has better things to do.

>ask scotland yard about phone number
Thank you so much, we will look into this right away .... Ok ....  The number is atrributed to two men. Why don't you give us the phone number.

>i
You are carrying:
  Necklace
  Code
  Phone number

>give scotland yard phone number
Thank you

>give scotland yard necklasce
You can't see any such thing.

>give scotland yard necklace
Thank you for this. We'll keep it safe

    *** you have found the culprit using your wits and logic. You have done a good job.  ***

Would you like to RESTART, RESTORE a saved game, QUIT or UNDO the last command?